ARE	AA R
ARE(2)	ER
BOT	B AA T
CHECK	CH EH K
FACEBOOK	F EY S B UH K
GOOGLE	G UW G AH L
HI	HH AY
HOW	HH AW
INTELLIGENT	IH N T EH L AH JH AH N T
IS	IH Z
JAVA	JH AA V AH
NAME	N EY M
OPEN	OW P AH N
REAL	R IY L
WHAT	W AH T
WHAT(2)	HH W AH T
WHO	HH UW
YOU	Y UW
YOUR	Y AO R
YOUR(2)	Y UH R
